11111111111111111
10000100000000111
10000000C00000001
10000000000111111
100P0C00000000001
10000100000111011
100000010010E0001
10000C00001000001
11111111111111111