11111111111111111
1CCCCCCCECCCPCCC1
11111111111111111